"地域","部","ひめじ","宇都宮","ドクター","田母神","鈴木","中川","ますぞえ","細川","マック","家入","ないとう","金子","五十嵐","酒向","松山","根上","選挙当日有権者数_男","選挙当日有権者数_女","選挙当日有権者数_計","投票者数_男","投票者数_女","投票者数_計","棄権者数_男","棄権者数_女","棄権者数_計","投票率_男","投票率_女","投票率_平均","前回投票率_男","前回投票率_女","前回投票率_平均"
"千代田区","区部",6.001,3303.998,373,4082,44,18,9106,5054,113,499,18,7,16,7,11,20,21211,21868,43079,11401,11599,23000,9810,10269,20079,53.75,53.04,53.39,69.55,66.97,68.24
"中央区","区部",21.002,8430.997,872,8980,76,44,23161,11130,200,1527,26,25,32,6,26,43,50414,57209,107623,26173,29232,55405,24241,27977,52218,51.92,51.1,51.48,64.96,63.46,64.16
"港区","区部",47,12968,1073,12738,133,46,34808,19792,334,2515,23,53,47,32,31,16,83874,98669,182543,40182,45516,85698,43692,53153,96845,47.91,46.13,46.95,61.97,59.3,60.53
"新宿区","区部",60.005,23910.994,1528,17484,237,61,47568,23949,405,2928,57,71,83,31,42,30,125187,126764,251951,58933,61049,119982,66254,65715,131969,47.08,48.16,47.62,61.03,62.48,61.76
"文京区","区部",46.002,19094.997,1294,12683,220,39,35767,19416,301,2092,61,77,64,37,32,26,78246,88005,166251,44052,48393,92445,34194,39612,73806,56.3,54.99,55.61,69.87,67.94,68.85
"台東区","区部",25,12873,1137,10603,169,57,30465,13654,272,1466,56,73,101,19,27,28,77856,73699,151555,36727,35326,72053,41129,38373,79502,47.17,47.93,47.54,62.33,63.31,62.81
"墨田区","区部",63.003,16661.996,1400,12785,214,48,43318,15805,344,1683,55,72,68,25,107,52,104468,104172,208640,47312,46629,93941,57156,57543,114699,45.29,44.76,45.03,61.67,61.38,61.53
"江東区","区部",155.017,34553.982,2733,24372,397,169,85994,30676,602,3238,133,138,154,62,82,48,192083,195953,388036,92434,93583,186017,99649,102370,202019,48.12,47.76,47.94,64.35,64.48,64.42
"品川区","区部",174.006,27925.993,2052,20133,273,114,61078,27334,473,3297,123,90,183,67,79,67,148570,156610,305180,71111,74280,145391,77459,82330,159789,47.86,47.43,47.64,62.96,62.79,62.87
"目黒区","区部",77,20414,1558,14147,284,159,42350,23912,331,3360,62,46,59,22,53,31,103040,119480,222520,51149,57107,108256,51891,62373,114264,49.64,47.8,48.65,63.74,61.46,62.51
"大田区","区部",132.01,50940.989,3447,35915,958,340,117563,47426,734,4351,191,221,191,42,84,89,286702,287847,574549,132832,133197,266029,153870,154650,308520,46.33,46.27,46.3,61.89,62.03,61.96
"世田谷区","区部",260.003,70486.996,4825,43762,815,210,140522,78097,1164,8753,214,164,196,74,176,97,335110,379498,714608,168861,185093,353954,166249,194405,360654,50.39,48.77,49.53,65.17,63.32,64.19
"渋谷区","区部",40,16343,1250,11315,201,42,31433,19646,307,3103,45,45,45,7,43,23,84273,94204,178477,40327,44628,84955,43946,49576,93522,47.85,47.37,47.6,61.63,60.8,61.19
"中野区","区部",73.005,26345.994,1690,17289,335,187,47958,24510,470,2840,82,65,89,25,92,53,132859,132115,264974,61553,62188,123741,71306,69927,141233,46.33,47.07,46.7,61.09,62.52,61.8
"杉並区","区部",146,50323,2838,28917,772,107,84583,48614,745,5358,149,88,196,52,150,69,217298,239617,456915,108174,117798,225972,109124,121819,230943,49.78,49.16,49.46,64.72,64.19,64.44
"豊島区","区部",110.005,20451.994,1450,14479,213,41,40212,19649,378,2286,70,74,64,23,55,36,110643,109213,219856,50529,50396,100925,60114,58817,118931,45.67,46.14,45.91,60.06,61.11,60.58
"北区","区部",163.005,29223.994,1909,16605,329,57,58526,23332,467,2136,106,117,104,47,78,65,136117,138987,275104,66819,68376,135195,69298,70611,139909,49.09,49.2,49.14,64.38,65.43,64.91
"荒川区","区部",38,13987,996,9486,192,176,33632,12414,258,1064,56,37,54,12,33,22,80413,81077,161490,36734,36740,73474,43679,44337,88016,45.68,45.31,45.5,60.22,59.72,59.97
"板橋区","区部",147.01,42145.989,2724,24836,507,158,87650,36069,666,3131,170,135,190,59,120,86,217656,222719,440375,99445,101766,201211,118211,120953,239164,45.69,45.69,45.69,60.48,60.68,60.58
"練馬区","区部",293.01,55917.989,3656,35023,714,326,115295,54756,810,4735,188,156,191,64,171,81,279910,295514,575424,135650,140137,275787,144260,155377,299637,48.46,47.42,47.93,64.01,63.67,63.84
"足立区","区部",159.027,40957.972,2944,25561,533,304,107352,35381,635,2781,161,186,207,45,176,207,268450,266505,534955,110821,109515,220336,157629,156990,314619,41.28,41.09,41.19,57.41,58.28,57.84
"葛飾区","区部",95.013,28493.986,1988,17521,412,140,69631,24206,425,1960,126,220,152,27,91,43,180218,180445,360663,74207,73099,147306,106011,107346,213357,41.18,40.51,40.84,58.89,59.49,59.19
"江戸川区","区部",174.02,34319.979,3147,27452,609,227,100423,33339,599,3051,181,158,142,78,178,78,266343,259217,525560,105951,100851,206802,160392,158366,318758,39.78,38.91,39.35,57.75,58.59,58.16
"八王子市","市部",157.016,37960.983,2081,18463,630,122,84394,37239,428,2238,140,105,175,55,157,54,226109,226870,452979,94658,91764,186422,131451,135106,266557,41.86,40.45,41.15,62.45,62.38,62.42
"立川市","市部",50,12339,699,7043,123,23,27225,11473,163,686,48,44,55,23,28,20,71649,72397,144046,30855,29933,60788,40794,42464,83258,43.06,41.35,42.2,61.98,61.21,61.59
"武蔵野市","市部",31,12494,734,6979,113,41,21887,14683,170,1168,40,30,22,15,34,9,55206,61564,116770,28503,30643,59146,26703,30921,57624,51.63,49.77,50.65,67.95,67.24,67.58
"三鷹市","市部",58.003,16053.996,924,8204,156,53,27952,15591,233,1455,46,58,42,15,38,27,71613,75418,147031,35372,36428,71800,36241,38990,75231,49.39,48.3,48.83,65.08,64.17,64.61
"青梅市","市部",36,8099,466,4018,142,53,21216,8025,105,340,32,89,57,16,26,26,56159,56254,112413,22316,21042,43358,33843,35212,69055,39.74,37.41,38.57,60.49,59.61,60.05
"府中市","市部",71.003,18969.996,1239,12017,300,46,41234,18319,266,1431,59,67,57,23,41,35,100872,99389,200261,48131,47185,95316,52741,52204,104945,47.71,47.48,47.6,63.72,64.34,64.02
"昭島市","市部",52,7317,456,4086,104,31,17960,6902,89,431,35,33,34,10,47,17,45624,45760,91384,19366,18764,38130,26258,26996,53254,42.45,41.01,41.73,59.95,59.42,59.69
"調布市","市部",52,18979,1143,11225,220,96,36342,17891,286,1639,66,42,83,28,51,36,88882,93129,182011,43995,45325,89320,44887,47804,92691,49.5,48.67,49.07,64.7,64.95,64.83
"町田市","市部",96.006,30207.993,1710,16610,388,182,69386,33055,393,2091,117,98,153,44,94,32,166164,174832,340996,77592,78722,156314,88572,96110,184682,46.7,45.03,45.84,64.51,63.95,64.22
"小金井市","市部",36,10562,564,5306,99,29,18178,10168,115,767,31,23,45,11,17,17,46883,48444,95327,23085,23425,46510,23798,25019,48817,49.24,48.35,48.79,65.59,65.13,65.36
"小平市","市部",45.005,15074.994,739,7350,164,67,28453,13675,172,971,65,33,66,23,68,25,72685,75663,148348,33526,34208,67734,39159,41455,80614,46.13,45.21,45.66,64.96,65.18,65.07
"日野市","市部",78,14638,887,7129,172,52,29724,13076,188,859,55,54,61,27,35,24,72640,72235,144875,34418,33466,67884,38222,38769,76991,47.38,46.33,46.86,64.99,64.57,64.78
"東村山市","市部",47,12716,648,5553,188,34,24127,10395,125,628,74,52,65,18,31,25,59917,63045,122962,27434,27919,55353,32483,35126,67609,45.79,44.28,45.02,64.06,64,64.03
"国分寺市","市部",19,10780,558,5385,150,38,19974,10036,120,777,43,28,39,11,46,11,47474,49179,96653,24184,24393,48577,23290,24786,48076,50.94,49.6,50.26,67.29,66.53,66.9
"国立市","市部",30,7263,358,3177,67,16,11669,6699,91,487,27,10,20,11,21,9,29602,30950,60552,14995,15297,30292,14607,15653,30260,50.66,49.42,50.03,67.85,67.43,67.64
"福生市","市部",16,3414,241,2195,64,26,9085,3007,56,216,14,10,15,6,10,19,23546,23455,47001,9683,8946,18629,13863,14509,28372,41.12,38.14,39.64,60.49,59.76,60.13
"狛江市","市部",23,7617,363,3428,75,23,13599,6637,92,501,24,15,26,8,15,25,31193,33290,64483,16006,16816,32822,15187,16474,31661,51.31,50.51,50.9,64.53,64.14,64.33
"東大和市","市部",17,6430,311,2673,98,21,13522,5620,53,301,25,22,23,7,18,15,33484,34330,67814,14718,14733,29451,18766,19597,38363,43.96,42.92,43.43,63.08,63.69,63.39
"清瀬市","市部",22.003,7188.996,300,2630,64,20,11974,5707,63,278,15,21,27,10,31,13,28614,31236,59850,13833,14838,28671,14781,16398,31179,48.34,47.5,47.9,65.09,64.35,64.7
"東久留米市","市部",51,10201,528,4110,93,49,18023,8645,113,432,22,26,26,6,22,24,45902,48194,94096,21045,21756,42801,24857,26438,51295,45.85,45.14,45.49,64.18,64.42,64.3
"武蔵村山市","市部",15,4259,238,1992,49,14,10139,3485,55,159,24,26,14,5,17,23,28291,28199,56490,10399,10327,20726,17892,17872,35764,36.76,36.62,36.69,57.65,59.5,58.57
"多摩市","市部",50,13859,621,6043,103,55,23585,12328,115,822,30,26,21,9,30,18,58808,61201,120009,28777,29471,58248,30031,31730,61761,48.93,48.15,48.54,66.05,65.9,65.97
"稲城市","市部",27,6090,380,3691,75,21,14536,6418,65,498,35,17,42,5,16,7,33902,33360,67262,16337,15935,32272,17565,17425,34990,48.19,47.77,47.98,66.19,65.91,66.05
"羽村市","市部",20,3429,196,1768,30,17,8357,3223,58,135,21,18,12,4,10,3,22900,22137,45037,9104,8391,17495,13796,13746,27542,39.76,37.9,38.85,59.95,60.35,60.15
"あきる野市","市部",18,5162,278,2292,73,19,12905,4862,79,178,16,24,16,6,16,9,32643,33048,65691,13361,12981,26342,19282,20067,39349,40.93,39.28,40.1,60.87,59.16,60.01
"西東京市","市部",48.005,16198.994,860,8427,185,75,31317,15543,220,1022,63,38,56,19,70,35,77566,82281,159847,36947,38115,75062,40619,44166,84785,47.63,46.32,46.96,64.56,64.15,64.35
"瑞穂町","西多摩郡",16,1510,106,860,34,18,5246,1580,41,77,10,14,5,2,6,4,13752,13326,27078,4932,4710,9642,8820,8616,17436,35.86,35.34,35.61,55.6,56.22,55.9
"日の出町","西多摩郡",11,1066,62,442,28,5,3234,1116,16,50,5,13,5,5,5,8,6764,7062,13826,3111,3030,6141,3653,4032,7685,45.99,42.91,44.42,66.22,63.39,64.78
"檜原村","西多摩郡",1,113,8,48,9,11,686,171,2,11,3,2,0,0,5,4,1091,1100,2191,561,528,1089,530,572,1102,51.42,48,49.7,70.92,67.11,69.03
"奥多摩町","西多摩郡",5,313,17,127,14,2,1334,346,8,6,10,15,3,4,3,3,2491,2586,5077,1135,1118,2253,1356,1468,2824,45.56,43.23,44.38,66.59,65.58,66.07
"大島支庁","島部",15.011,1179.988,80,745,18,10,3838,800,25,55,18,15,4,5,17,8,5488,5675,11163,3440,3544,6984,2048,2131,4179,62.68,62.45,62.56,70.73,68.37,69.53
"三宅支庁","島部",6,268,15,143,4,1,824,217,3,14,4,3,3,0,0,2,1433,1223,2656,828,712,1540,605,511,1116,57.78,58.22,57.98,66.39,67.34,66.83
"八丈支庁","島部",3.011,540.988,54,348,10,12,2197,746,21,33,5,8,9,3,4,6,3413,3419,6832,1980,2091,4071,1433,1328,2761,58.01,61.16,59.59,68.14,68.32,68.23
"小笠原支庁","島部",1,223,26,190,5,0,462,224,8,26,0,1,2,0,2,1,1138,866,2004,666,527,1193,472,339,811,58.52,60.85,59.53,68.18,68.08,68.14
